111111111111111111111111111111
1E000000000000C000000000000001
11111111000000100001010111C001
100000010000001100000000100001
10000001110C000111110C00100C01
100001000000000C00000000000001
1P0001000001111110000000000001
100001000000001100C00000000001
10000100000000000000000C000001
111111111111111111111111111111
