111111111111111111111111111111
140000000000002000000000000001
100100010000001000010101112001
130000010000001100000000100001
100000011102000111110200100201
100000000000000200000000000001
111111111111111111111111111111